	Basic Conversation		
GREETING_INFORMAL	Hello	வணக்கம்	Vanakkam
GREETING_MORNING	good morning	காலை வணக்கம்	kalai vanakkam
GREETING_EVENING	good evening	மாலை வணக்கம்	malai vanakkam
GREETING_DEPARTURE	goodbye	குட்பை	good bye
SORRY	sorry / excuse me 	மன்னிக்கவும் / என்னை மன்னியுங்கள்	Maṉṉikkavum/ eṉṉai maṉṉiyuṅkal
PLEASE	please	தயவு செய்து	dhaiva seythu
THANKS	thank you / thanks	நன்றி / நன்றி	nanri / nanri
REPLY_THANKS	you're welcome [response to thank you / thanks]	நன்றி / நன்றி	nanri / nanri
GIVE_OWN_NAME	my name is...	என் பெயர்.	en peyer
ASK_OTHERS_NAME	What is your name?	உன் பெயர் என்ன?	Un peyer enna?
GIVE_OWN_PROVENANCE	I’m from...	நான் இருந்து இருக்கிறேன் ...	Nāṉ iruntu irukkiṟēṉ...
FAMILY	family	குடும்ப	kudumbam
PRESENT_HUSBAND	this is my husband	இவர் என் கணவர்	Ivar eṉ kaṇavar
WIFE	my wife	என் மனைவி	Eṉ maṉaivi
CHILDREN	my children	என் குழந்தைகள்	Eṉ kulandhaigal
DAUGHTER	my daughter	என் மகள்	Eṉ maghaḷ
SON	my son	என் மகன்	Eṉ maghaṉ
BABY	my baby	என் குழந்தை	Eṉ kuḻandhai
BROTHER	this is my brother	இது எனது சகோதரர்,	Idhu eṉu cakōtarar,
SISTER	this is my sister	இந்த என் சகோதரி	Inta eṉ cakōtari
FATHER	this is my father	இந்த என் தந்தை	Inta eṉ tantai
MOTHER	this is my mother 	இவர் என் அம்மா	Ivar eṉ am'mā
SUFFER_HUNGER	I’m hungry.	எனக்கு பசிக்கிறது .	Eṉakku pacikkiṟatu.
CHILD_HUNGRY	(My child) is hungry	என் குழந்தை ) பசி	Eṉ kuḻantai) paci
SUFFER_THIRST	I’m thirsty	எனக்கு தாகமாக உள்ளது	Eṉakku tākamāka uḷḷatu
WATER	water	நீர்	Nir
AVAILABLE_Q	Do you have...	நீங்கள்...	Nīṅkaḷ...
LOCATION_Q	Where is..?	எங்கே ..?	Eṅkē..?
TOILET_LOCATION_Q	Where is the toilet? / Where is the bathroom?	கழிவறை எங்கே?"/எங்கே குளியலறை உள்ளது ? "	Kaḻivaṟai eṅkē?"/Eṅkē kuḷiyalaṟai uḷḷatu?
NEED_SHOWER	I need to take a shower	நான் எங்கே மழை எடுக்க?	Nāṉ eṅkē maḻai eṭukka?
SHOWER_LOCATION_Q	Where can I take a shower?	சுகாதார திண்டு/துண்டு	Cukātāra tiṇṭu/Tuṇṭu
SANITARYPAD	sanitary pad / towel	டயபர்/துணியை	Ṭayapar/Tuṇiyai
DIAPER	diaper / nappy	நான் ஒரு போன் செய்ய வேண்டும்	Nāṉ oru pōṉ ceyya vēṇṭum
NEED_MAKE_PHONECALL	I need to make a phone call	பிரார்த்தனை செய்ய	Pirārttaṉai ceyya
PRAY_LOCATION_Q	Where can I pray?	நான் எங்கே buy_____ முடியும்?	Nāṉ eṅkē buy_____ muṭiyum?
PURCHASE_X_LOCATION_Q	Where can I buy_____?	நான் எங்கே find____ முடியும்?	Nāṉ eṅkē find____ muṭiyum?
LOCATION_X_Q	Where can I find____?	இது என்ன காலம் ?	Itu eṉṉa kālam?
TIME_CLOCK_Q	What time is it?	தூங்க	Tūṅka
NEED_SLEEP	I (we) need to sleep	சுரங்கப்பாதை / நிலத்தடி உள்ளது?	Curaṅkappātai/ nilattaṭi uḷḷatu?
SUBWAY_LOCATION_Q	Where is the subway/underground?	நான் எந்த பணம் இல்லை.	Nāṉ enta paṇam illai.
NO_MONEY	I don’t have any money.	நீ பேசுவாயா...	Nī pēcuvāyā...
SPEAK_X_Q	Do you speak...	நீங்கள் ஆங்கிலம் பேசுவீர்களா?	Nīṅkaḷ āṅkilam pēcuvīrkaḷā?
SPEAK_LITTLE_X	I don't speak (English) very well.	நீங்கள் எனக்கு அந்த கீழே எழுத முடியும்?	Nīṅkaḷ eṉakku anta kīḻē eḻuta muṭiyum?
WRITE_DOWN_X_REQUEST	Can you write that down for me?	எனக்கு புரியவில்லை	Eṉakku puriyavillai
NO_UNDERSTAND	I don’t understand	உதவும் ! / தயவு செய்து உதவுங்கள்!	Utavum! / Tayavu ceytu utavuṅkaḷ!
HELP_REQUEST	Help! / Please help me!	எனக்கு தெரியாது	Eṉakku teriyātu
IGNORANCE	I don’t know	என்ன நடந்தது?	Eṉṉa naṭantatu?
EVENT_Q	What happened?	நான் குளிர் இருக்கிறேன் / முடக்கம்	Nāṉ kuḷir irukkiṟēṉ/ muṭakkam
SUFFER_FREEZING	I am cold/ freezing	நான் சந்தோஷமாக இருக்கிறேன்.	nāṉ cantōṣamāka irukkiṟēṉ.
EXPERIENCE_HAPPINESS	I’m happy.	நான் பயந்துவிட்டேன்.	Nāṉ payantuviṭṭēṉ.
SUFFER_FEAR	I’m scared.	நான் சோகமாக இருக்கிறேன்.	Nāṉ cōkamāka irukkiṟēṉ.
SUFFER_SADNESS	I’m sad.	நான் உன்னை விரும்புகிறேன்.	Nāṉ uṉṉai virumpukiṟēṉ.
EXPERIENCE_LIKING_ADDRESSEE	I like you.	கவலைப்பட வேண்டாம்	Kavalaippaṭa vēṇṭām
DONT_WORRY	Don’t worry	நான் ஒரு சந்திப்பு விரும்புகிறேன்.	Nāṉ oru cantippu virumpukiṟēṉ.
NEED_APPOINTMENT	I would like an appointment.	எங்கே அறை எண் ____ உள்ளது?	Eṅkē aṟai eṇ ____ uḷḷatu?
ROOM_NUMBER_N_LOCATION_Q	Where is room number ____?	எங்கே பதிவு மையமாக உள்ளது?	Eṅkē pativu maiyamāka uḷḷatu?
REGISTRATION_CENTRE_LOCATION_Q	Where is the registration centre?	நீங்கள் காத்திருக்க வேண்டும்	Nīṅkaḷ kāttirukka vēṇṭum
MUST_WAIT	You have to wait	எத்தனை காலம் நாங்கள் இங்கே காத்திருக்க வேண்டும்?	ettaṉai kālam nāṅkaḷ iṅkē kāttirukka vēṇṭum?
WAITING_TIME_DURATION_Q	How long do we have to wait here?	ஒரு நாள்	Oru nāḷ
1_DAY	one day	ஒரு மணி நேரம்	oru maṇi nēram
1_HOUR	one hour	ஒரு மாதம்	oru mātam
1_MONTH	one month	மிக விரைவில்	mika viraivil
VERYSOON	very soon	நாளை	nāḷai
TOMORROW	tomorrow	நாளை மறுநாள்	nāḷai maṟunāḷ
DAY_AFTER_TOMORROW	the day after tomorrow	அடுத்த வாரம்	aṭutta vāram
NEXT_WEEK	next week	நான் விரைவில் திரும்பி	nāṉ viraivil tirumpi
RETURN_SOON	I will be back soon	ஒன்று இரண்டு மூன்று நான்கு ஐந்து ஆறு ஏழு எட்டு ஒன்பது பத்து	oṉṟu iraṇṭu mūṉṟu nāṉku aintu āṟu ēḻu eṭṭu oṉpatu pattu
ONE	one	ன்று 	oṉṟu
TWO	two	ரண்டு 	iraṇṭu
THREE	three	ூன்று 	mūṉṟu
FOUR	four	ான்கு 	nāṉku
FIVE	five	ந்து 	aintu
SIX	six	று 	āru
SEVEN	seven	ழு 	ēḻu
EIGHT	eight	ட்டு 	eṭṭu
NINE	nine	ன்பது 	oṉpatu
TEN	ten	த்து 	paththu
MONDAY	Monday	திங்கள் 	tiṅkaḷ 
TUESDAY	 Tuesday	செவ்வாய் 	cevvāy 
WEDNESDAY	 Wednesday	புதன் 	putaṉ 
THURSDAY	 Thursday	வியாழன் 	viyāḻaṉ 
FRIDAY	 Friday	வெள்ளி 	veḷḷi 
SATURDAY	 Saturday	சனி 	caṉi 
SUNDAY	 Sunday	ஞாயிறு	ñāyiṟu
JANUARY	January	ஜனவரி	jaṉavari
FEBRUARY	 February	 பிப்ரவரி	 pipravari
MARCH	 March	 மார்ச்	 mārc
APRIL	 April	 ஏப்ரல்	 ēpral
MAY	 May	 மே	 mē
JUNE	 June	 ஜூன்	 jūṉ
JULY	 July	 ஜூலை	 jūlai
AUGUST	 August	 ஆகஸ்ட்	 ākasṭ
SEPTEMBER	 September	 செப்டம்பர்	 cepṭampar
OCTOBER	 October	 அக்டோபர்	 akṭōpar
NOVEMBER	 November	 நவம்பர்	 navampar
DECEMBER	 December	 டிசம்பர்	 ṭicampar
	Medical Terms		
NEED_DOCTOR	I need a doctor		
SUFFER_ICD10_R11	I feel sick/ I don't feel well 		
EXPERIENCE_ILLNESS	I’m ill / I’m sick		
CHILD_ILL	(My child) is sick		
PREGNANT	I am pregnant		
SUFFER_ICD10_T78.4	I am having an allergic reaction		
SUFFER_ICD10_H81	I feel dizzy.		
SUFFER_ICD10_E10	I am diabetic		
NEED_INSULIN	I need insulin		
SUFFERED_RAPE	I was raped.		
SUFFER_ICD10_R10	I have a stomach ache.		
SUFFER_ICD10_R50	I have a fever / a temperature		
SUFFER_ICD10_R51	I have a headache		
SUFFER_ICD10_R05	I have a cough.		
CHILD_SUFFER_ICD10_R7.0	My child has a sore throat/ cough		
FLU	cold		
DIARRHEA	diarrhea		
ICD10_K59.0	constipation		
ICD10_B73.3	vaginal yeast infection (thrush)		
ICD10_B53.3	athlete's foot		
ICD10_B85	head lice		
			
	Food		
MEAL_NOON	Lunch		
MEAL_EVENING	Dinner		
FOOD_HALAL_Q	Is this food Halal?		
ALLERGY_AGAINST_X	I am allergic to….		
PORK_MEAT	pork		
POULTRY_MEAT	poultry		
NO_EAT_PORK	I do not eat pork		
SELF_VEGETARIAN	I am a vegetarian.I don’t eat meat and fish.		
SELF_VEGAN	I am a vegan		
FISH	fish		
BREAD	bread		
WATER	water		
LEMONADE	lemonade		
MILK	milk		
COFFEE	coffee		
TEA	tea		
BEER	beer		
FRUITS	fruit		
APPLE	apple		
PEAR	pear		
GRAPEFRUIT	grapefruit		
APRICOT	apricot		
POTATOE	potatoes [pl]		
BEAN	beans [pl]		
PEA	peas [pl]		
CHICKPEA	chickpeas [pl]		
AUBERGINE	eggplant (US) / aubergine (UK)		
CARROT	carrots [pl]		
TOMATO	tomatoes [pl]		
TURNIP	turnip		
FLOUR	flour		
HONEY	honey		
CHEESE	cheese		
QUARK	quark / cottage cheese 		
PAPRIKA	paprika		
SAUCE	sauce		
BUTTER	butter		
OIL	oil		
CHEWING_GUM	chewing gum		
SPOON	spoon		
KNIFE	knife		
PLATE	plate		
GLASS	glass (to drink from)		
MUG	mug		
TEAPOT	teapot 		
			
	Clothing		
SHIRT	shirt		
DRESS	Dress		
SKIRT	skirt		
TROUSERS	trousers (UK) / pants (US)		
PULLOVER	jumper (UK) / sweater / pullover		
COAT	jacket / coat		
HEADSCARF	veil / hijab / headscarf		
SHOE	shoes [pl]		
GLOVE	gloves [pl]		
SOCK	socks [pl]		
UNDERWEAR	underwear		
			
	Misc		
BED	bed		
BLANKET	blanket		
LAMP	lamp		
TELEPHONE	telephone		
CELLPHONE	mobile phone / cellphone		
ELECTRICITY	electricity		
COMPUTER	computer		
INTERNET_CONNECTION	internet connection		
BATTERY	battery		
ROOM	room		
CHAIR	chair		
TABLE	table		
TOILET	toilet		
TOILET_PAPER	toilet paper		
TOOTHBRUSH	toothbrush		
TOOTHPASTE	toothpaste		
SHOWER	shower		
BATHTUB	bathtub		
SOAP	soap		
SHAMPOO	shampoo		
HANDKERCHIEF	tissue / handkerchief		
CUPBOARD	cupboard		
DOOR	door		
WINDOW	window		
WALL	wall		
HOUSE	house		
APARTMENT	apartment / flat		
BOOK	book		
NEWSPAPER	newspaper		
RADIO	radio		
TELEVISION	television		
