NEED_DOCTOR	I need to see a doctor	Mi treba doktor
NEED_HOSPITAL	I need to go to the hospital	Moram da odam vo bolnica
NEED_AMBULANCE	I need an ambulance	Mi treba ambulantno vozilo
WHERE_GET_MEDICINE	Where can I fill this prescription?	Kade mozam da go podignam ovoj recept? 
WHEN_RETURN	When do I have to come back?	Koga treba da dojdam povtorno
HOSPITALIZATION_Q	Do I have to be admitted to the hospital?	Dali treba da me primat vo bolnica
SUFFER_ICD10_J45	I have asthma	imam astma
SUFFER_ICD10_J41	I have chronic bronchitis	Imam hronicen bronhitis
SUFFER_ICD10_I50	I have heart failure	Imam slabo srce
SUFFER_ICD10_I21	I had a myocardial infarction	Imav infarkt
SUFFER_ICD10_G40	I have epilepsy	Imam epilepsija
SUFFER_ICD10_C00	I have cancer	Imam rak
SUFFER_ICD10_A16	I have tuberculosis	Imam tuberkuloza
SUFFER_ICD10_E10	I have diabetes	Imam dijabetis
SUFFER_HIV	I have HIV	Imam HIV
SUFFER_ICD10_C90	I have leukaemia	Imam leukemija
SUFFER_ICD10_D57	I have sickle cell disease	Imam srpesta anemija
SUFFER_ICD10_D56	I have thalassaemia	Imam talasemija
SUFFER_ICD10_F32	I have chronic depression	Imam hronicna depresija
SUFFER_ICD10_F20	I have schizophrenia	Imam shizofrenija
SUFFER_ICD10_F31	I have bipolar disorder	Imam bipolarno poremetuvanje
HERE_MY_MEDICATION	This is my medication	Ova se moite lekovi
DAILY_MEDICATION	I take this medication every day	Ovie lekovi gi zemam sekoj den
PERMANENT_MEDICATION	I have been taking this medication for years	Ovie lekovi gi zemam so godini
NEED_MORE_MEDICATION	I need more of this medication	Mi treba ovoj lek
SUFFER_INJURY	I was injured	Jas bev povreden/povredena
SUFFER_BEATING	Somebody hit me	Nekoj me udri
SUFFER_KNIFING	I was stabbed/ cut with a knife	Ranet/Raneta sum od noz
SUFFER_CAR_ACCIDENT	I was hit by a car	Me udri kola/avtomobil
SUFFER_STING	I was stung by an insect	Me bocna insekt
SUFFER_BITE	I was bitten	Kasnat sum/Me kasna...
SUFFER_FALL_FROM_HEIGHT	I fell from a height	Padnav od visoko
SUFFER_FALL 	I fell down	Padnav
HERE_PAIN	It hurts here	Tuka me boli
PAIN_MOVES_A_B	The pain started here and goes to here	Bolkata zapocna tuka i premina tuka
PERMANENT_PAIN	The pain is there all the time	Bolkata e postojana
NON_PERMANENT_PAIN	The pain comes and goes	Bolkata e povremena
PAIN_WHEN_TOUCHED	It hurts when I touch it	Me boli na dopir
PAIN_WHEN_STANDING	It gets worse when I stand up	Se vlosuva koga ke zastanam
PAIN_WHEN_LYING	It gets worse when I lie down	Se vlosuva koga ke legnam
SHARP_PAIN	It is a sharp pain	Bolkata e ostra
DULL_PAIN	It is a dull pain	Bolkata e tapa
SUDDEN_PAIN	The pain started suddenly	Bolkata zapocna odednas
GRADUAL_PAIN	The pain started gradually	Bolkata zapocna postepeno
KNOWN_PAIN	I have had this pain before	Ja imav ovaa bolka i prethodno
UNKNOWN_PAIN	I have never had this pain before	Nikogas ne sum ja imal/a ovaa bolka 
SUFFER_BLEEDING	I am bleeding	Krvaram
SUFFER_ICD10_R31	There is blood in my urine	Imam krv vo urinata
SUFFER_ICD10_K92	There is blood in my faeces	Imam krv vo stolicata
SUFFER_ICD10_K92	There is blood in my vomit	Povrakam krv
SUFFER_ICD10_R04.2	I am coughing up blood	Kaslam krv
SUFFER_ICD10_K62	I am bleeding from my anus	Krvaram od anusot
SUFFER_ICD10_R04.0	I have a nosebleed	Mi tece krv od nosot
SUFFER_ICD10_N93	I am bleeding between my periods	Krvaram megju menstruacii
SUFFER_ICD10_N95	My periods finished, but I am bleeding again	Seuste krvaram i posle menopauza
FMA_7154	head	glava
FMA_54448	eye	oko
FMA_52780	ear	uvo
FMA_49184	mouth	usta
FMA_24728	face	lice
FMA_7155	neck	grlo
FMA_25202	shoulder	ramo
FMA_24901	elbow	lakt
FMA_24964	hip	kolk
FMA_24974	knee	koleno
FMA_9665	ankle	zglob
FMA_9664	foot	stapalo
FMA_24890	arm	raka
FMA_24979	leg	noga
FMA_9712	hand	dlanka
FMA_9666	finger	prst
FMA_25046	toe	palec
FMA_9576	chest	gradi
FMA_9577	belly	abdomen
FMA_7088	heart	srce
FMA_7195	lung	bel drob
FMA_7148	stomach	stomak
FMA_7202	gallbladder	zolcka
FMA_7203	kidney	bubreg
FMA_7199	bowel	crevo
FMA_15711	anus	anus
FMA_17558	uterus	matka
FMA_7209	ovary	jajnici
FMA_19949	vagina	vagina
FMA_7210	testes	testisi
FMA_9707	penis	penis
SUFFER_SICKNESS	I feel ill	Se cuvstvuvam bolen
SUFFER_ICD10_R50	I have a fever	imam temperatura
FREEZING	I feel cold	Ladno mi e
SUFFER_SHIVERING	I have been shaking	Se tresam
SUFFER_COLD_SWEAT	I had a cold sweat	Me obleva studena pot
SUFFERED_ICD10_R55	I fainted	Se onesvestiv
SUFFER_ICD10_H81	I feel dizzy	Mi se vrti
SUFFER_ICD10_G40	I had a seizure	Dobiv napad 
SUFFER_ICD10_R55	I was unconscious	Izgubiv svest
SUFFER_ICD10_R06	I have difficulty breathing	Imam problemi so disenjeto
SUFFER_ICD10_R06.2	I have wheezing	Se zabrevtuvam
SUFFER_ICD10_R05	I have a cough	Imam kaslica
SUFFER_ICD10_R09.3	I am coughing up sputum	Iskasluvam slajm
SUFFER_ICD10_I47	My heart beats fast	Srceto mi bie zabrzano
SUFFER_ICD10_I49	My heart beats irregular	Srceto mi bie neredovno
SUFFER_CHEST_PAIN	I have chest pain	Imam bolki vo gradite
SUFFER_STOMACH_PAIN	I have stomach ache	Me boli stomakot
SUFFER_ICD10_R11	I feel sick	Loso mi e
SUFFERED_VOMITING	I have been sick	Povrakav
SUFFER_ICD10_A09	I have diarrhoea	Imam dijarea
SUFFER_ICD10_K59	I have constipation	Imam zapek
VOMITING_OF_ALL_INGESTED	I vomit up all food and drinks	Ja povrakjam seta hrana i tecnosti
SUFFER_ICD10_N39.3	I urinate every hour	Uriniram sekoj cas
SUFFER_ICD10_R30.9	I have pain when urinating	Imam bolki pri uriniranje
SMELLY_URINE	My urine smells bad	Mojata urina mirisa loso
SUFFER_ICD10_R30.0	I can´t urinate	Ne mozam da uriniram
SUFFER_ICD10_R10	I have colic pain in my side	Imam uzasna bolka od strana
MAYBE_PREGNANT	I might be pregnant	Mozebi sum bremena
BLEEDING_DURING_PREGNANCY	I am pregnant and I am bleeding	Bremena sum i krvaram
UTERINE_CONTRACTION	I am in labour	Imam kontrakcii
SEX_TWO_DAYS_AGO	I last had sex 2 days ago	Imav seks pred 2 dena
LONG_TIME_NO_SEX	I have not had sex for a long time	Ne sum imal seks dolgo vreme
DISEASESDB_28137	I have a discharge from my vagina	Imam iscedok od vaginalniot otvor
SUFFER_ICD10_N34	I have a discharge from my urethra	Imam iscedok od mocniot otvor
SUFFERED_RAPE	I have been raped	Bev siluvan/a
SUFFER_ICD10_R20.1	My ... feels numb	Nemam oset vo...
SUFFER_ICD10_R20.2	My .. is tingling	Cuvstvuvam trnenje vo...
WEAK_X	My .. is weak	Mojot/mojata/moeto... e oslabnat/a/o
PARALYSED_X	My .. is paralysed	Mojot/mojata/moeto... e paraliziran/a/o
INABILITY_TO_SPEAK	I cannot speak	Ne mozam da zboruvam
SUFFER_ICD10_H54	I cannot see	Ne mozam da gledam
SUFFER_ICD10_R51	I have a headache	Imam glavobolka
SUFFER_ICD10_M54.2	I cannot flex my neck	Ne mozam da go dvizam vratot
SUFFER_FEAR	I feel frightened	Se plasam
SUFFER_DEPRESSION	I feel depressed	Deprimiran/a sum
SUFFER_SADNESS	I feel sad	Tazen/a sum
SUFFER_ICD10_R45.8	I think about suicide	Razmisluvam da se samoubijam
SUFFER_ICD10_R44.0	I hear voices when i am alone	Koga sum sam/a, slusam glasovi
FEEL_OBSERVED	I feel like I'm being watched	Imam cuvstvo deka nekoj me gleda
Läuse, Filzläuse, Magenwürmer, Karies, blaue Flecken, Verstauchung, Kater, diverse Drogen, Tinnitus, trockener Mund, Rheuma, Seitenstechen, Prellung, Beule, Quetschugn, Verbrennung		
Steifheit, Unterkühlung, Hitzschlag, Sonnenbrand, Sonnenstich, Gehirnerschütterung, Ertrinken und Verwandtes, Erstickung und Verwandtes, Schnittwunden, Brüche		
